11111111111111111111111111111111111111
1P0000000C00000C00000000111100C0011011
10000011110000011000101010101011000101
10000C000000C0000011000000C00011100011
10101010101011010101011100C0000110C011
1000000C000111000011C0110000110000C001
100000111100001110100C00C00110000C0011
100C00000C000C000001000C0000110C001111
10101010101C010100000011100110000C0011
1000C00C000011000001010101010101111011
10000011110000111001010100C00001111011
1000C0000110000C00010101C0101001000001
1001100C00E00111000000C00010011C001111
10101010101011110111000C0000110C001001
11111111111111111111111111111111111111