1111111111111111111
1P00000000000000001
1000001111000001101
10000C0000000000001
1010101010101101011
1000000C00011100001
1000001111000011101
100000000C000000001
1010101010100101001
1000000C00001100001
1000001111000011101
100000000110000C001
1001100000E00000001
1010101010101111011
1111111111111111111