111111111111111
1P0000000C00001
101110111011101
100000100C00001
101011101110101
100010101000001
100010001010001
100001100110001
1011100000C0001
111111111111111