11111
1P0E1
1C1C1
10111
1C1C1
11111