1111111111
1C00000001
1111111101
1CE00P0001
1111111111