111111111111
1P0000000001
101111111101
1C0000000001
101010101101
100010001001
101010101101
1C000000E001
111111111111