111111111111
1P0000000001
100000000001
100C00000001
100000000001
100000000001
100000000001
10000000E001
111111111111