11111111111111111111
1P000000000000000001
10000011110000011101
10000C00000000000001
10101010101010101011
1000000C000011100001
10000011110000011101
100000000C0000000001
10101010101010101001
1000000C000000000001
10000011110000011101
1000000000000000C001
1000000000E000000001
10101010101010101011
11111111111111111111