111111111111
1P0001000001
101110111101
100000C00001
101011101101
100000000001
1C0100010001
10000E000001
111111111111