111111111111111
1P0000000000001
101110111011101
100000C00000001
101011101110101
100010C01000001
1000100010C0001
100000C00000001
1000C00000E0001
111111111111111