111111111111
1P0000000001
100111011101
1C0011000001
101101110101
100000000001
100111100001
10000E0000C1
111111111111