111111111111
1000000P0001
100111011101
10001100C001
101101110101
100000000001
100111100001
100000000E01
111111111111