111111111111111
100C0010C0000C1
10000100000P001
100001000000001
1000001C0000001
1000C0000C000C1
100000E00000001
111111111111111