11111111111
1P000E00001
11111111111
1C000000101
10101010101
1C001101001
10101001101
11111111111