1111111111111111111111111111111111111
1PCCCCCCCCCCCCCCCCCCCCCCCCCCCCCCCCCP1
1CCCCCCCCCCCCCCCCCCCCCCCCCCCCCCCCCCC1
1CCCCCCCCCCCCCC111111111CCCCCCCCCCCC1
1CCCCCCCCCCCCCCCCCC1CCCCCCCCCCCCCCCC1
1CCCCCCCCCCCCCCCCCC1CCCCCCCCCCCCCCCC1
1CCCCCCCCCCCCCCCCCC1CCCCCCCCCCCCCCCC1
1CCCCCCCCCCCCCCCCCC1CCCCCCCCCCCCCCCC1
1CCCCCCCCCCCCCC1CC1CCCCCCCCCCCCCCCCC1
1CCCCCCCCCCCCCCC11CCCCCCCCCCCCCCCCCC1
1CCCCCCCCCCCCCCCCCCCCCCCCCCCCCCCCCCC1
1CCCCCCCCCCCCCCCCCCCCCCCCCCCCCCCCCCC1
1CCCCCCCCCCCCCCCCCCCCCCCCCCCCCCCCCCC1
1CCCCCCCCCCCCCCCCCCCCCCCCCCCCCCCCCCE1
1111111111111111111111111111111111111