11111
1P1E1
10101
10101
10001
11111