11111
1P101
1C1C1
10101
1C0C1
11111