11111
1P1E11
1C1C01
101001
1C0C01
111111