11111
101E1
1C1C1
10101
1C0C1
11111