11111
1P1E1
1C1C1
10101
1C0C1
11011