11111111111111111111111111111111111
1010010011C0C001CC01000C001C10C0011
10C00100C00000100101010000C0C00C001
1100001100000000000001101000000CC01
10001100C11000C1000C010000000011101
1000C01100001000000000001C01C011C01
10CC000C00000000010C001001010001001
1C10PC01010000C000C000CE0C000000001
1C0100001010000010C0000100CC001C001
100100C0000C001010001C0000C1000C011
111010100010C0010C10001C1C001000001
11111111111111111111111111111111111
