111111111111111
1P00000C0000001
101110111011101
10000010C000001
101011101110101
100010101000001
100010001010001
100001100110001
101110C000E0001
11111111111