11111111111
1P000000001
10111110011
1C000000101
10101010101
1C0E1101001
10101001101
11111111111